11111111111111111111111111
10000P01000011000010000001
10111111111011000000000001
100000000000000000000C00E1
11111111111111111111111111